20
00000000000000000000
00110001100001100000
01010010010010100000
00100001100011000000
00000000000000000000
00000100000000000000
00001010000000000000
00010010000111000100
00001100000000001010
00000000000000010100
00000000110000001000
00011000110000000000
00100100000000000000
00100100000000000000
00011000001000000000
00000000010100000100
00000000001000001010
00010110000000010100
00011010000000011000
00000000000000000000
