15
000000000000000
000000000000000
000000000000000
000111111011000
000111111011000
000000000011000
000110000011000
000110000011000
000110000011000
000110000000000
000110111111000
000110111111000
000000000000000
000000000000000
000000000000000
