20
00000000000000000000
00000000000000000000
01110000000000000000
00000000000000000000
00000000000000000000
00000000000000000000
00000000000000000000
00000000000000000000
00000001110000000000
00000001110000000000
00000001110000000000
00000000001110000000
00000000001110000000
00000000001110000000
00000000000000000000
00011100000000000000
00001110000000000100
00000000000000000100
00000000000000000100
00000000000000000000
