10
0000000000
0000000000
0000000000
0000000000
0001000000
0000100000
0011100000
0000000000
0000000000
0000000000
